010101010100000000000000000000000000000000000
0101000100000000000000000000000000000000000
00100000000000000000000000000000000000000
010100000000000000000000000000000000000000
01000000000000000000000000000000000000000
010100000009395530000000000000000000000000
01010000000EC600C3000000000000000000000000
0000000000000008570000000000000000000000
0000000000000D160F000FFF0000000000000000
00000000000000C30F00000F0000000000000000
00000000000000960FFF0FFF0000000000000000
00000000000000A0000F0F000000000000000000
00000000000000C3000F0FFF0000000000000000
0000000000095556000009300000000093000000
00000000000A0095530956A0000000956A000000
000D5555555200A0085600C5553000C53A000000
00000000000C30A00A00000000C530956A000000
000000000000C5600A0000000000C5600A955553
00000000000000000C300000000000000AA0B956
000000000000000000C55557000000000C60C600